revolution	(n.)革命
calorie	(n.)【热量单位】卡，卡路里
province	(n.)省
ward	"n.病房；选区；受监护人；v.守护，躲开"
immigrant	"n.移民，外侨；adj.移民的"
shaver	(n.)电动剃须刀
industry	(n.)行业
pride	(n.)自豪
bring in	"phr.增加，赚取，产生，引进"
amuse	(v.)逗乐
astronomy	(n.)天文学
flexible	(adj.)灵活的
pretend	(v.)假装，装扮
lack	(n.)缺乏，短缺；v.缺乏
reform	(n.)改革
registration	(n.)登记，注册，挂号
radioactive	(adj.)辐射的，放射性的
donate	(v.)捐赠
commonwealth	(n.)英联邦
confidential	(adj.)机密的；表示信任的
characteristic	(n.)特征
fascinate	(v.) 使着迷
accommodation	(n.) 住宿，膳宿
conference	(n.) 会议
regain	(vt.) 恢复；重新获得
likely	(adj.) 有可能的
request	"n.（正式或礼貌的）请求；要求；v.请求，要求"
resemble	(vt.) 类似，相似
citizenship	(n.)国籍
mime	"n.默剧表演，默剧；v.表演默剧，做口型"
conscience	(n.)良心，良知
prisoner	(n.)囚犯，俘虏
rigid	(adj.)死板的
architect	(n.)建筑师
abstract	(adj.)抽象的
acute	(adj.)严重的；敏锐的
dull	"adj.枯燥的，沉闷的；愚笨的，迟钝的"
dairy	"adj.奶制的，牛奶的；n.牛奶厂"
annual	(adj.)年度的，一年一次的
call on	(phr.)要求（某人讲话等）
burglar	(n.)窃贼
odor	(n.)（常指难闻的）气味
scold	(v.)怒骂，责骂，训斥
quotation	(n.)引文，语录
Buddhism	(n.)佛教
thermos	(n.)热水瓶，保温瓶
passer-by	(n.)过客，过路人