reunite	(v.) 重逢，再次相聚
wrinkle	(n.) 窍门
forbid	(v.) 禁止
capsule	(n.) 胶囊；航天舱，密封舱
data	(n.) 数据
selflessly	(adv.) 无私地
breakdown	"n.故障，损坏；分解；倒塌，崩溃"
subscribe	(vi.) 订阅
sustainable	(adj.) 可持续的
courtroom	(n.) 法庭；审判室
motto	"n.座右铭；格言；箴言；口号"
pursue	(v.) 追求
exploit	(v.) 利用
dismiss	(v.) 不考虑
steady	(adj.) 稳步的
motor	"n.马达，发动机；adj.机动车的"
impair	(v.) 损害
imprisonment	(n.) 监禁
stain	"n.污渍，污迹；v.弄脏；玷污；染色"
description	(n.) 描写，形容，叙述
merchant	(n.) 商人；批发商
cater	(v.) 迎合，满足需要
ink	(n.) 墨水，油墨
fierce	"adj.激烈的；凶猛的，凶狠的"
paddle	"v.用脚（手）划水，荡桨；n.桨"
systematic	(adj.) 系统的，有条理的
adopt	(v.) 采纳，采用；收养
bless	(vi.) 有幸具有
misunderstand	(v.) 误解，误会
military	(adj.) 军事的
petal	(n.) 花瓣
barbershop	(n.) 理发店
noble	(adj.) 贵族的，高贵的
claim	"v.声称；认领，要求（拥有）；n.声明"
irrigation	(n.) 灌溉
announcer	(n.) 播音员
afterwards	(adv.) 以后
unrest	(n.) 不安，骚动；动荡的局面
potter	(n.) 陶工
cage	(n.) 笼，鸟笼
brighten	(v.) （使）变亮
sugary	(adj.) 含糖的，甜的
extinct	(adj.) 灭绝的；（火山）死的
trigger	"vt.触发，引起，激发；n.诱因"
combat	"n.战斗，格斗；v.与……战斗，与……斗争（读…"
tank	(n.) 水槽，池塘
construction	(n.) 建造；建筑；构造
tolerate	"vt.忍受，容忍；容许，允许"
contribute	"v.有助于；贡献；促成，导致"
permission	(n.) 允许，同意
steadily	(adv.) 持续地，稳步地
religious	(adj.) 宗教的
brick	(n.) 砖
cell	(n.) 细胞；电池
distribute	(v.) 分配；分发
likability	(n.) 讨喜度
entirely	(adv.) 完全地
mineral	(n.) 矿物，矿物质；矿产
overall	"adj.全面的，全部的；adv.总体上；总共（读…"