furious	狂怒的
confess	承认；坦白
hostile	敌对的
remedy	治疗方法；
pointed	尖的;突出的
coconut	椰子
hell	地狱
plankton	浮游生物
firmness	坚定；坚固
indicative	象征的；指示的
lifeless	无生命的；无趣味的
gamble	赌博
cease	停止
empathetic	移情的；有同感的
presently	一会儿；现在
auditorium	观众席；礼堂
exertion	发挥；运用
drugstore	药店
discreet	谨慎的
dramatize	戏剧化
association	"n.协会，联盟，社团；关联；联想";联合；联盟
gram	(n.)克;克
nephew	(n.)侄子，外甥;侄子；外甥
analytical	(adj.)分析的;分析的
dominant	(adj.)主要的，占优势的;支配的;显性的；占优势的
loose	(adj.)宽松的;松的；松散的
competent	(adj.)有能力的;有能力的
economic	(adj.)经济上的，经济学的;经济的
