resolve	"v. 解决（问题或困难）   ；消 除"
monumental	(adj.) 意义深远的 ，不朽的
workforce	(n.) 劳动力
tuition	(n.) 学费
structure	(n.) 结构；建筑物
characteristic	(n.) 特征
intensity	(n.) 强烈 ，剧烈
digest	(n.) 文摘
presumably	(adv.) 大概 ，据推测 ，可能
survey	(n.) 调查；   v. 调查
construct	(v.) 建造
violence	(n.) 暴力 ，暴行
unprecedented	"adj. 前所未有的 ，空前的， 无前例的"
misunderstanding	(n.) 误解 ，误会 ，不和
scare	(v.) 使害怕 ，惊吓
fabric	(n.) 布料 ，织物
obtain	(v.) 获得 ，赢得 ，取得
angle	(n.) 角度；立场
weed	(n.) 杂草 ，野草；   v. 除杂草
expansion	(n.) 扩大 ，扩充 ，扩张 ，扩展
variable	"n. 变量 ，可变物；   adj. 易 变的 ，可变的"
accomplish	"vt. 实现； （通过努力）  完 成"
modify	(v.) 更改，  改造
cite	(vt.) 引用，  引证
tone	(n.) 语气
noble	(adj.) 贵族的 ，高贵的
apparently	(adv.) 显然
compromise	"n. 妥协 ，折中；   v. 使遭受 危险"
massive	"adj. 大规模的；  巨大的；大 量的；非常严重的"
laundry	"n. 洗衣物 ，洗衣物的活；洗 衣房；洗衣店；要洗的衣服"
launch	(v.) 发射；创办 ，开始从事
manufacture	(v.) （批量）  生产 ，制造
bias	(n.) 偏见；   v. 使有偏见
vegetation	(n.) 植被
substantial	(adj.) 大量的
industrial	(adj.) 工业的
reinforce	(v.) 加强
shipbuilder	(n.) 造船工人
literate	(adj.) 能读会写的
reptile	(n.) 爬行动物 ，爬虫
composer	(n.) 作曲家
failure	(n.) 失败；失败者
overview	(n.) 综述 ，概观
autonomy	(n.) 自主权
realism	(n.) 现实主义
purify	(v.) 使纯净 ，净化
evidence	(n.) 证据 ，证明；   v. 证明
territory	(n.) 领域；范围
vivid	"adj. 生动的 ，清晰的（ 记 忆 、描述）"
variation	(n.) 差异；  [生物] 变异 ，变种
philosophy	"n. 生活信条（或态度）   ；哲 学 ，哲学体系"
fragile	"adj. 易碎的；易损坏的；虚 弱的；脆弱的"
justify	"v. 证明 … …正确或有理；使 (文本) 对齐"
renowned	(adj.) 著名的
sailing	(n.) （乘帆船）航行
industry	(n.) 行业
garage	(n.) 车库
session	"n. 会议；一场；一段时间的 （ 活动）"
despite	(prep.) 尽管 ，不顾
colleague	(n.) 同事
file	(n.) 文件
rescue	(n.) 救援；   v. 挽救
beginner	(n.) 初学者
clinic	(n.) 诊所，  门诊部
comment	"n. 评论；   v. 评论 ，表达意 见"