put off	延 期
put up	举起；挂起
refer to	参考；涉及；指的是
run out of	用完；耗尽
save one's life	挽救某人生命
see...off	为……送行
sell out	售 完
shake hands with	与……握手
show off	炫耀
so far	到目前为止
so that	(表示目的)为了，以便
some day	将来有一天
sooner or later	迟早
stand for	代表
stay up	熬夜
stop...from	阻止……做
take action	采取行动
take hold of	抓住
take off	脱掉(衣物等)；起飞
after all	终究；毕竟
all over	到处
all the way	一路上
as long as	只要
ask for	请求；寻求
at least at most	至少/至多
at once	立刻；马上
be careful with	小心
be fond of	爱好
be keen on	喜爱
be located in or on or at	位于