admit	"v.承认；准许进入；接纳，接收（入学）"
emergency	"n.紧急情况，突发事件；adj.紧急情况下的；应急的"
reservation	"n.（住处、席位的）预订；（美国印第安部落的）居…"
range	"n.范围，界限；一系列；v.（在一定范围内）变化"
react	"vi.起反应，对……做出反应"
survey	(n.) 调查
maple	(n.) 枫树
anecdote	(n.) 轶事，趣闻
suck	"v.吮，啜，吸；n.吸吮，吸力"
object	"n.物体；对象；v.反对（读作/əbˈdʒekt/）"
prayer	(n.) 祈祷，祷告
perform	(v.) 运行；表演；表现；执行
microscope	(n.) 显微镜
scar	"n.伤疤，伤痕；内心创伤；v.给……留下伤痕"
recognize	"vt.认出，辨别；v.认可；公认"
physicist	(n.) 物理学者，物理学家
appoint	(v.) 委派，任命
stubborn	(adj.) 顽固的
sailor	(n.) 水手，海员
astonish	(vt.) 使十分惊讶
accompany	(v.) 陪伴；陪同
rejoice	(v.) 感到欣喜，感到高兴
operator	(n.) 经营者
arrangement	(n.) 安排；布置
rotten	(adj.) 腐烂的，腐朽的
profession	(n.) 职业
comment	"n.评论；v.评论，表达意见"
surrounding	(n.) 环境
thunder	(n.) 雷，雷声
jazz	(n.) 爵士乐
jelly	(n.) 果冻，肉冻；胶状物
nail	(v.) 将……钉牢，钉住
socialism	(n.) 社会主义
badge	(n.) 徽章
motorcycle	(n.) 摩托车
original	"adj.最初的，原始的，原来的；有独创性的，独创的…"
relieve	(v.) 减轻
policy	(n.) 政策，方针
liberty	(n.) 自由
trustworthy	(adj.) 可信赖的，可靠的
major	"adj.主要的；严重的；n.主修（科目）；主修学生…"
stewardess	"n.（飞机上的）女服务员，空姐；女管家"
astonishing	(adj.) 令人惊讶的
blank	"n.空白，空白处；adj.（纸等）空白的；茫然的"
swell	(v.) 膨胀，鼓起
jet	"n.喷气式飞机；vi.乘坐喷气式飞机"
competent	(adj.) 有能力的
curriculum	"n.课程，（学校或专业的）全部课程"
depressed	(adj.) 意志消沉的
ton	(n.) 吨
flood	(v.) 大量涌入；n.洪水
roast	"adj.烤的，烘的；v.烤，焙，烘"
measurement	(n.) 衡量，测量；尺寸
propose	(vt.) 提议；vi.求婚
signal	(n.) 信号；v.表明
tightly	(adv.) 紧紧地
outwards	(adv.) 向外地
colleague	(n.) 同事
misunderstanding	(n.) 误解，误会，不和
strict	"adj.（条例、法规等）严格的；严厉的"
corner	(n.) 角落，角；拐角
nationality	(n.) 国籍
consume	"vt.消耗，消费；吃，喝，饮"
greet	(v.) 问候，招呼
tear	"v.撕裂，撕碎（读作/ter/）；n.眼泪（读作/tɪr/）"
je vais	我去
tu vas	你去
il va	他去
elle va	她去
j'ai	我有（当动词以原音开头，je要改成j')
tu as	你有
il a	他有
elle a	她有
j'ai un passeport	我有一个护照
gants	手套
gustave	古斯塔夫（人名）
tango	探戈舞；探戈舞曲
compagne	同伴；伴侣；伙伴
espagnol	西班牙的；西班牙语；西班牙人
l'aéroport	这个/那个机场
aéroport	机场
l'avion	这个/那个飞机
aéro	“大气”和“航空”（名词）
hotel	旅馆,饭店
Tu vas à Paris	你要去巴黎
avion	飞机
Tu vas à la gare	你要去火车站
un avion	一架飞机
C'est un hotel espagnol	这是一家西班牙酒店
passeport	护照
j'ai une valise	我有一个手提箱
valise	手提箱
il a une valise	他有一个手提箱
marc a un passeport	"Marc有一本护照"
tu as un avion	你有飞机吗？
voiture	汽车
tu as une voiture francaise	你有一辆法国汽车
billet	票,入场券,门票，（车、船）票
s'il vous plait	请给我
billet d'avion	机票
Où est le taxi	出租车在哪里？
tu prends la voiture	你乘坐汽车吗？
un restaurant	一家饭馆
Montréal	蒙特利尔（加拿大主要港市）
le restaurant espagnol	那家西班牙饭馆
berlin	柏林
c'est une gare francaise	这是一座法国火车站
chanson	歌曲
tu vas à l'aéroport	你去这个机场
Elle	她
Je	我
un	一
joli	漂亮的
mon	我的
fils	儿子
bébé	宝宝
mange	吃
fromage	奶酪
aime	喜欢
deux	二
sexual	(adj.) 性别的；性的；性感的
roughly	(adv.) 大约，粗略地
vacant	(adj.) 空缺的
musician	(n.) 音乐家，作曲家
visa	(n.) 签证
participant	(n.) 参与者，参加者
bench	(n.) 长凳
article	(n.) 文章
rocket	(n.) 火箭，火箭弹
AIDS	"abbr.艾滋病，获得性免疫缺陷综合征"
tight	(adj.) 严密的；紧张的
sideways	"adv.向侧面地；侧；斜着地；adj.旁边的；斜着…"
express	(v.) 表达；adj.快速的
frequent	"adj.时常的，频繁的（读作/ˈfrikwənt/）"
tense	(adj.) 紧张的
feast	(n.) 盛宴，特别的享受
schedule	"n.时间表，计划表；v.预订，安排"
Mexico	(n.) 墨西哥
boxing	(n.) 拳击；盒式包装
skim	(v.) 掠过，滑过
flashlight	(n.) 手电筒
minimum	"adj.最少的，最低（限度）的；n.最低限度，最小量"
incident	(n.) 事件
aviation	(n.) 航空，航空学
garment	(n.) 服装
recover	"v.恢复；痊愈，恢复健康；收回"
knot	"n.绳结，结合，树的节；v.打结"
area	(n.) 区域，地区
equipment	(n.) 设备，器材
rank	"v.排名；n.地位；等级，级别"
habitat	(n.) 栖息地，生活环境
studio	(n.) 工作室
businessman	(n.) 商人
academy	(n.) 学院
arbitrary "adj.随意的，任性的，随心所欲的"
summary (n.) 摘要，总结
inject (v.) 给……注射
bead (n.) 珠子
conduct "v.进行；表现（读作/kənˈdΛkt/）"
genuine (adi.)真的;真正的;真诚的
adequate (adj.)足够的，充分的
pause "v.暂停，中止；n.（说话或朗读中的）停顿；中止…"
extraordinary (adj.) 非同寻常的
species (n.) 物种
extend (v.) 扩展；延长；提供，给予
combination (n.) 结合，联合
bid	"n.出价；投标；努力争取；v.出价；投标；问候；道…"
berry	(n.) 浆果
shorten	(v.) 缩短，（使）变短
ribbon	(n.) 缎带，丝带
cleaner	(n.) 清洁器
appliance	(n.) 家用电器，器具
airmail	(n.) 航空邮件
generation	(n.) 一代人；产生
whether	(conj.) 是否；不管，无论
pleasant	(adj.) 令人愉快的，舒适的
outstanding	(adj.) 杰出的，出众的
heart	"n.心，心脏；内心；关键，核心；中心，中央"
cocoa	(n.) 可可粉
proportion	(n.) 比例
eyesight	(n.) 视力
pioneer	"n.先锋，先驱；vt.开辟，首倡"
humorous	(adj.) 幽默的，搞笑的
remain	"link-v.保持；v.剩余；n.遗迹"
contribution	(n.) 贡献
region	(n.) 地区，区域，地带
tendency	(n.) 趋向，趋势，倾向
bucket	"n.水桶，（有提梁的）桶；大量；v.颠簸行进；装…"
subjective	(adj.) 主观的，个人的
mist	(n.) 薄雾
fry	"v.油炸；n.油炸食物；(adj.) 油炸的，油煎的…"
troop	"n.军队，部队；群；vi.结队而行"
dynamic	(adj.) 动态的
illustration	(n.) 插图
rugby	(n.) 英式橄榄球
database	(n.) 数据库
apartment	(n.) <美>公寓
pearl	(n.) 珍珠；珠状物
clumsily	(adv.) 笨拙地
inject	(v.) 给……注射
bead	(n.) 珠子
majority	(n.) 大多数，大部分
toward	(prep.) 向；对于
critic	(n.) 批判者
ripen	(v.) 使……成熟
merciful	(adj.) 仁慈的，宽大的
conduct	"v.进行；表现（读作/kənˈdΛkt/）"
brewery	(n.) 啤酒厂
ambassador	(n.) （特命全权）大使
merely	(adv.) 只是，仅仅，只不过
household	(n.) 家庭
abuse	(n.) 滥用
nominate	(v.) 提名
quantity	(n.) 数量，数额；大量，许多
prosperous	(adj.) 富裕的；茁壮生长的
magpie	(n.) 【鸟类】喜鹊；饶舌者
transform	(v.) 改变，转换
lightning	(n.) 闪电
preview	(n.) （电影、戏剧等的）试映
dash	(v.) 猛冲，突进
hugely	(adv.) 非常地
chemist	(n.) 化学家
seashell	(n.) 贝壳，海贝
interview	"n.面试；采访；v.采访；面试"
overlook	"v.忽视，未注意到；眺望，俯视"
aggressive(adj.)有攻击性的:好斗的
exceed (v.)超过
explicit(adj.)明确的
energetic"adi.精力充沛的"
famine (n.)饥荒;严重的缺乏
destination(n.)目的地
advancements 进步，进展，升任
alongside  "prep.在旁边，和....并排，和...一起;
apparently(adv.)显然
report (n.)报告，汇报;v.报道
genuine(adi.)真的;真正的;真诚的
funeral(n.)丧葬，葬礼
frost "n.霜冻，严寒;v.撒上糖霜
frown(v.)皱眉;不赞成;n.皱眉
adequate(adj.)足够的，充分的
diversity(n.)多样性，差异，不同
fame(n.)火焰;热情
pregnant(adj.)怀孕的，妊娠的
favor(n.)味，风味
scale(n.)规模
guidance(n.)指导，引导
enterprise"n.企业(或事业)单位 ，公司”
identify(v.)识别出;确定，鉴定
programmer(n.)程序员
illegal(adj.) 非法的
enquire (v.)询问，打听
dust (n.)尘士，沙士
marine	(adj.) 海洋的
percent	(n.) 百分比
nutrition	(n.) 营养
operation	"n.手术；经营；行动，活动；运转"
moral	"adj.道德（上）的，道义的；n.道德，品行"
require	(v.) 需要；要求，规定
particularly	(adv.) 特别地，尤其
suffering	(n.) 疼痛，苦难
pause	"v.暂停，中止；n.（说话或朗读中的）停顿；中止…"
sculpture	(n.) 雕刻，雕塑
postage	(n.) 邮费
principle	(n.) 原则；原理
salary	(n.) 工资，薪水
German	(n.) 德语；adj.德国的
gum	(n.) 口香糖
proposal	(n.) 提议；建议
sample	"n.(用于检验、分析的)试样，样品"
ancestor	(n.) 祖先
extraordinary	(adj.) 非同寻常的
significance	(n.) 意义，含义
describe	(v.) 描述
dislike	(v.) 不喜欢
commitment	(n.) 承诺，许诺
heaven	(n.) 天堂；极乐世界
widow	(n.) 寡妇，遗孀
million	(num.) 百万；许多
diverse (adj.) 多样的
shave "v.剃（须发），刮脸；n.剃须，修面"
constant (adj.) 持续不断的
establish "v.建立；使成为；确立；创立"
enthusiastic "adj.狂热的，极感兴趣的；热情的"
gorilla (n.) 大猩猩
Switzerland (n.) 瑞士
contemporary (adj.) 当代的，现代的
grave "adj.严肃的，庄重的；n.墓"
convince (vt.) 使信服
ape (n.) 类人猿
greed (n.) 贪欲，贪婪；贪吃
current (adj.) 当前的，现在的
greengrocer (n.) 蔬菜水果商
dial (n.) 仪表盘
grizzly (n.) 灰熊；adj.灰色的
goods (n.) 货物，商品
define (v.) 给（词、短语等）下定义
circumstance (n.) 情况；环境
evident "adj.显然的，明显的，明白的"
seminar (n.) 研讨会
carry out (phr.) 开展
evolve (v.) （使）逐渐发展；进化
forum (n.) 论坛
gram (n.) 克
grand "adj.大的；壮丽的，宏伟的，宏大的"
awkward (adj.) 尴尬的
racial (adj.) 种族的；人种的
accord (n.) 协议；vt.授予
associate "v.关联；联系；与......有关；adj.副的；n.伙伴…"
boast "v.吹嘘；夸耀；（地方、机构等）自豪地拥有（好的…"
glare (n.) 眩目的光；v.怒目而视
commissioner (n.) 委员，专员，理事
burden (n.) 负担
congress (n.) 国会
adjust (v.)调整，调节;适应
metropolitan (adj.)大城市的，大都会的
feature "n.特征，特点，特色;v.以..….为主要组成
association "n.协会，联盟，社团;关联，联想"
overcome (vt.)克服
exceed (v.)超过
force "v.强迫;n.力量;军队，部队”
famine (n.)饥荒;严重的缺乏
fertilizer (n.)肥料，化肥
apparently (adv.) 显然
genuine (adj.) 真的；真正的；真诚的
acknowledge (vt.) 承认；认可
fragile "adj. 易碎的；易损坏的；虚弱的；脆弱的"
sow (v.) 播种；种
motivate (vt.) 激励
precisely "adv. 准确地；精确地；恰恰"
fence (n.) 篱笆， 围栏 ，栅栏
fertile (adj.) 肥沃的
overnight "adv. 整夜 ，一夜之间 ，突然（读作/ ˌouvər ˈnaɪt/） …"
mass "adj. 大量的；n. 大量 ，一堆； [物]质量"
fuel (n.) 燃料；v. 加强；激起
chaos (n.) 混乱 ，纷乱
efficiency (n.)效率
obvious "adj.明显的，显而易见的;了无新意的;平
budget (n.)预算;v.预算 ，安排
dread "v.惧怕，害怕;n.畏惧，恐惧;adi.恐怖的使…"
administration (n.) 管理 ，行政
anxiety (n.) 焦虑
drawer (n.) 抽屉
garlic (n.) 大蒜
assess (vt.) 评估
economics (n.) 经济学；经济情况
engage (v.) 参加；使订婚
disadvantage	(n.) 弊端
set	"v.创建，建立；调整好；（小心地）放置；n.一…"
diverse	(adj.) 多样的
shave	"v.剃（须发），刮脸；n.剃须，修面"
grocer	(n.) 食品杂货商
species	(n.) 物种
ecology	(n.) 生态
guilty	(adj.) 内疚的
effective	(adj.) 有效的
constant	(adj.) 持续不断的
establish	"v.建立；使成为；确立；创立"
exist	(vi.) 存在
encounter	"vt.邂逅，偶遇；n.相遇，邂逅"
enthusiastic	"adj.狂热的，极感兴趣的；热情的"
give in	(phr.) 屈服
haircut	(n.) 理发；发型
expense	"n.开销，开支；花费，费用；代价"
max	"abbr.<非正式>最大的，最大限度的（同maximum）"
extend	(v.) 扩展；延长；提供，给予
discourage	(vt.) 阻拦；阻止；使泄气
facility	(n.) 设施，设备
gorilla	(n.) 大猩猩
Switzerland	(n.) 瑞士
atmosphere	(n.) 氛围，气氛；大气；空气
geology	(n.) 地质学
alcoholic	(adj.) 含酒精的
geometry	(n.) 几何学；几何形状
awkward	(adj.) 尴尬的
germ	"n.细菌；（某事的）发端，萌芽"
racial	(adj.) 种族的；人种的
accord	(n.) 协议；vt.授予
apart	"adv.成碎片；分离地，分开地；相隔，相距"
professional	(adj.) 专业的；n.专业人员
laptop	(n.) 笔记本电脑
ham	(n.) 火腿
giant	(adj.) 巨大的，特大的
associate	"v.关联；联系；与......有关；adj.副的；n.伙伴…"
gifted	(adj.) 有天赋的；有才华的
tractor	(n.) 拖拉机，牵引车
boast	"v.吹嘘；夸耀；（地方、机构等）自豪地拥有（好的…"
glance	(n.) 一瞥，扫视；v.看一下
glare	(n.) 眩目的光；v.怒目而视
outdrive	(v.) 驾车快于
glory	(n.) 光荣，荣誉
commissioner	(n.) 委员，专员，理事
burden	(n.) 负担
instrument	(n.) 仪器；乐器
congress	(n.) 国会
entertainment	(n.) 娱乐
adjust (v.)调整，调节;适应
circuit(n.)电路，线路
fluent(adj.)(语言)讲得流利的
metropolitan(adj.)大城市的，大都会的
feature "n.特征，特点，特色;v.以..….为主要组成
association"n.协会，联盟，社团;关联，联想"
geologist(n.)地质学家
stewardship"n.管理员、服务员等的职位和职责
aggressive(adj.)有攻击性的;好斗的
adolescent(n.)青少年;adi. 青春期的
theme(n.)主题
effort (n.)努力;力气，精力
scent (n.)气味
host"n.主人，东道主;节目主持人;大量;v.主持，主办”
overcome(vt.)克服
energize (v.)使..精力充沛
bill "n. 账单;纸币 ，钞票;议案 ，法案”
equality(n.)同等，:平等;【数】 等式
eruption(n.)喷发
exceed (v.)超过
force"v.强迫;n.力量;军队，部队”
explicit(adj.)明确的
wheat(n.)小麦
energetic"adi.精力充沛的 ，充满活力的"
condition"n.条件;状况，状态;v使适应，使处于良好状态”
rise"v.升起，上升，上涨;增长;升高 …"
convenience(n.)方便;便利设施
famine(n.)饥荒;严重的缺乏
destination(n.)目的地
entertaining(adi.)有趣的，令人愉快的使变成粉
powder(n.)粉末;火药:细雪;.抹粉:酒粉于
access"n.(使用或见到的)机会，权利;接触，通道;访问”
endeavor"n.尝试 ，努力 ，尽力;v.努力 ，尽力
dozen(num.)许多;一打，十二个
category(n.)类别
gather (v.聚集;收集:采集:使.聚集
infer 推断vt.
advancements 进步，进展，升任
easy-going(adj.)随和的
fasten(v.)扎牢;扣住
fertilizer (n.)肥料，化肥
