wax	(n.) 蜡
acknowledge	(vt.) 承认；认可
stewardship	"n. 管理员 、服务员等的职位和职责"
foresee	(vt.) 预测 ，预料
aggressive	(adj.) 有攻击性的；好斗的
surround	(vt.) 包围
bandage	(n.) 绷带
format	(n.) 格式；版式
survive	"vi. 生存 ，活着；vt. 艰难度过"
fortnight	(n.) 两星期
Africa	(n.) 非洲
vast	"adj. 大量的；辽阔的；巨大的"
adolescent	(n.) 青少年；adj. 青春期的
theme	(n.) 主题
oval	(adj.) 椭圆形的；n. 椭圆形
effort	(n.) 努力；力气 ，精力
fragile	"adj. 易碎的；易损坏的；虚弱的；脆弱的"
scent	(n.) 气味
razor	(n.) 剃刀 ，刮胡刀
get on with somebody.	(phr.) 与 … …相处
framework	(n.) 框架 ，结构
cattle	(n.) （总称）牛 ，牲口
franc	(n.) 法郎
sow	(v.) 播种；种
recovery	(n.) 痊愈
shortage	(n.) 短缺 ，不足 ，缺少
flame	(n.) 火焰；热情
pregnant	(adj.) 怀孕的 ，妊娠的
survival	(n.) 生存
flavor	(n.) 味 ，风味
don	"n.（牛津或剑桥大学的）指导教师 ，大学教师；v. …"
flesh	(n.) 肉，肉体；果肉
sprinkler	(n.) 洒水装置 ，洒水车
lecture	(n.) 演讲
rush	"v. 冲 ，奔；n.（交通）繁忙时段"
scale	(n.) 规模
scare	(v.) 使害怕
pedestrian	(n.) 步行者 ，行人
fluency	(n.) 流畅 ，流利
trade	"n. 贸易 ，商业；职业；手艺；行当；v. 经商 ，交易"
weed	(n.) 杂草 ，野草
producer	"n. 电影制片人；生产商；制造商；产地"
fluently	(adv.) 流利地
tourism	(n.) 旅游 ，观光
construct	"v. 建造；构想 ，构筑 ，构思（ 思想 、作品 、体系等）…"
ranger	(n.) 护林员
fold	(v.) 折叠
academic	(adj.) 学术的；n. 学者
achievement	(n.) 成就
forehead	(n.) 前额 ，前部
investment	(n.) 投资
motivate	(vt.) 激励
feather	(n.) 羽毛
precisely	"adv. 准确地；精确地；恰恰"
federal	(adj.) 联邦制的
sparrow	(n.) 麻雀
fence	(n.) 篱笆，  围栏 ，栅栏
fertile	(adj.) 肥沃的
otherwise	"adv. 否则；在其他方面，另 ，亦；  除此之外"
overnight	"adv. 整夜 ，一夜之间 ，突然（读作/ ˌouvər ˈnaɪt/）  …"
outer	"adj. 外面的 ，外层的 ，外边的"
mass	"adj. 大量的；n. 大量 ，一堆；  [物]质量"
fiber	(n.) 纤维（物质）
training	(n.) 训练 ，锻炼；培训
popularity	(n.) 流行；受欢迎
fuel	(n.) 燃料；v. 加强；激起
envy	(n.) 妒忌；v. 嫉妒；羡慕
chaos	(n.) 混乱 ，纷乱
gasoline	(n.) <美>汽油
precious	(adj.) 珍贵的，  宝贵的
firmly	(adv.) 坚固地 ，稳固地
purchase	(vt.) 购买；n. 购买
coast	(n.) 海岸 ，海滨
elementary	(adj.) 小学的；基本的
finance	(n.) 金融
brand	(n.) 品牌
energize	(v.) 使......精力充沛
boil	(v.) 用开水煮 ，在沸水中煮
bill	"n. 账单；纸币 ，钞票；议案 ，法案"
equality	(n.) 同等 ，平等； 【数】  等式
pillow	(n.) 枕头
eruption	(n.) 喷发
exceed	(v.) 超过
ethics	(n.) 行为准则；道德规范
mop	(v.) 用拖把拖洗 、擦抹
financial	"adj. 金融的；经济的；财务的"
keeper	(n.) 饲养员；管理人；看守人
symphony	(n.) 交响乐
exotic	"adj. 奇异的 ，珍奇的 ，来自异国的"
force	"v. 强迫；   n. 力量；军队，部队"
expectation	(n.) 期望；预期
former	(adj.) 以前的
explicit	(adj.) 明确的
wheat	(n.) 小麦
eyebrow	(n.) 眉毛
bridegroom	(n.) 新郎
duration	(n.) 持续时间
greatly	(adv.) 大大地
eyewitness	(n.) 目击者
dare	(v.) 敢于
energetic	"adj. 精力充沛的 ，充满活力的"
engine	(n.) 引擎
condition	"n. 条件；状况 ，状态； v.使适应 ，使处于良好状态"
rise	"vi. 升起 ，上升 ，上涨；增长； （权力或地位）升高 …"
enlarge	(v.) 放大 ，扩展
consequence	(n.) 结果；后果
enormous	(adj.) 巨大的
well-known	(adj.) 有名的 ，著名的
convenience	(n.) 方便；便利设施
microphone	(n.) 话筒 ，麦克风
fetch	(vt.) 取来
dine	"v. 用正餐（或晚餐）；吃饭 ，用餐；招待 … … 吃饭"
enquiry	(n.) 询问
disapprove	(vi.) 不同意
tooth	(n.) 牙齿
exhausted	(adj.) 精疲力竭的；耗尽的
faithfully	(adv.) 忠实地
over	"prep. 多于；超过；在 …期间 ；遍及；在 … …上方；…"
famine	(n.) 饥荒；严重的缺乏
author	(n.) 作者 ，作家
drill	(n.) 演习
gradually	(adv.) 渐渐地
entry	"n. 进入；参赛作品；竞赛答题；入口处"
embassy(n.)大使馆，大使馆全体人员
decade(n.)十年，一个年代
destination (n.)目的地
ecological(adj.)生态的，生态学的
barber(n.)理发师;理发店
obvious "adj.明显的，显而易见的;了无新意的;平
entertaining(adj.)有趣的，令人愉快的
upload (v.)上传;上载;n.上传
powder (n.)粉末;火药;细雪;v.抹粉;洒粉于，使变成粉
drawback(n.)缺点
access"n.(使用或见到的)机会，权利;接触，通道;访问"
elect (v.)选举 ，推选，选择
draft(n.)草稿
embassy(n.)大使馆;大使馆全体人员
volcanic (adj.)火山的
destination(n.)目的地
endeavor"n.尝试 ，努力 ，尽力;v.努力 ，尽力’
palm(n.)棕榈树
ecological(adj.)生态的，生态学的
dusk(n.)黄昏，傍晚
garlic(n.)大蒜
easy-going(adj.)随和的
dozen(num.)许多;一打，十二个
category(n.)类别
engage(v.)参加，使订婚fasten(v.)扎牢，扣住
fertilizer(n.)肥料，化肥
loyal (adj.忠心的 ，忠诚的;的;n.…
collapse (n.崩溃;v.崩溃
crash (n.撞车;碰撞;坠毁;崩溃;轰隆声;v.碰撞;…"
scan(v.细看;浏览;扫描;详细调查;押韵;【计】 扫描 …"
due (adj.由于，因为;预期的;到期的'
owed (adj.亏欠的;负债的，感恩的"
detector (n.探测器
desperate (adj.拼命的
gather (v.聚集;收集;采集;使..聚集
considerable (adi.相当大的
ample (adj.富足的，丰满的，宽敞的
compassionate(adj.有同情心的
gesture 手势，姿势n.
infer 推断vt.
abundance 大量;丰富，充裕n
fragrant 芬芳的，香的adj.
advancements 进步，进展，升任n
athlete 运动员，田径运动员n.
damp 潮湿的，有湿气的，adi.抑制v
moisture 水分，潮湿，湿度，湿气n
intend 打算 v.
bare 空的adj.
glow 发光，发出微光;vi.光亮，光辉 n.
conflict 冲突，争执，矛盾n.
credit	(n.) 信用；学分
administration	(n.) 管理 ，行政
anxiety	(n.) 焦虑
drawer	(n.) 抽屉
garlic	(n.) 大蒜
eastward	(adv.) 向东；adj. 向东的
easy-going	(adj.) 随和的
assess	(vt.) 评估
fingernail	(n.) 手指甲
drag	(v.) 拖 ，拉 ，拽 ，扯
paragraph	(n.) （文章的）段 ，节；段落
economics	(n.) 经济学；经济情况
baseball	(n.) 棒球（运动）
drunken	(adj.) 喝醉的；酗酒的
dozen	(num.) 许多；一打 ，十二个
category	(n.) 类别
editor	(n.) 编辑
cash	(n.) 现金
engage	(v.) 参加；使订婚
biology	(n.) 生物学
fasten	(v.) 扎牢；扣住
fertilizer	(n.) 肥料 ，化肥
decoration	(n.) 装饰
drum	(n.) 鼓；圆桶； v. 击鼓
technique	(n.) 技巧，技能；技术，方法
disturbing	(adj.) 令人不安的
anxious	(adj.) 焦虑的，不安的；渴望的；急切的
source	(n.) 来源
origin	(n.) 起源；由来，来源；出身
period	(n.) （一段）时间；时期
potential	(adj.) 潜在的，可能的； n.潜力，潜能；可能性
rescue	(n.) 救援； v. 挽救
delete	(v.) 删除
resident	(n.) 居民
trait	(n.) 特征
divorce	(n.) 离婚，离异； v. 离婚
honor	(n.) 荣誉； vt. 尊敬，对……表示敬意
planet	(n.) 行星
dizzy	(adj.) 头晕目眩的，（非正式）傻乎乎的
dot	(n.) 点，圆点
departure	(n.) 离开
vital	(adj.) 必不可少的，至关重要的
essential	(adj.) 必不可少的，极其重要的；本质的；重要的；基…
crucial	(adj.) 关键的，至关重要的；决定性的
sort	(n.) 种类； v. 把……分类，整理，挑选
undemanding	（adj. 容易的；要求不高的；不严格的"
triumph	（n. 喜悦 ，狂喜；胜利，  凯旋；   vi. 成功 ，获胜"
victory	（n. 胜利；成功；克服
hip	（n. 臀部
soil	（n. 泥土 ，土壤；  国土 ，领土；   vt. 弄脏；污损"
undertake	（v. 承担 ，承包
ingredient	（n. 成分 ，构成要素； （烹调的）原料"
golf	（n. 高尔夫球运动
leopard	（n. 豹
devoted	（adj. 热衷的 ，致力于 … 的
loyal	（adj. 忠心的 ，忠诚的； （ 顾客）忠实的；忠贞的；   n. …"
collapse	（n. 崩溃；   v. 崩溃
crash	（n. 撞车；碰撞；坠毁；崩溃；轰隆声；   v. 碰撞；  …"
scan	（v. 细看；浏览；扫描；详细调查；押韵； 【计】  扫描 …"
chief	（adj. 首席的 ，最高级别的；主要的；   n. 首领 ，酋长"
secondary	（adj. 第二的；  次要的；  (疾病 、感染等) 继发性的；  …"
due	（adj. 由于，  因为；预期的；到期的"
owed	（adj. 亏欠的；负债的；感恩的"
diagram	（n. 图表
chart	（n. 图表 ，表格；航海图；每周排行榜；   vt. 制成图表 …"
evidence	（n. 证据，证明
transmission	（n. 传输，发射
sensor	（n. 传感器
detector	（n. 探测器
desperate	（adj. 拼命的
gather	（v. 聚集；收集；采集；使......聚集
delta	（n. （河流的）三角洲
considerable	（adj. 相当大的
ample	（adj. 富足的；丰满的；宽敞的
annually	（adv. 每年
opposite	（adj. 相反的；对立的；对面的； adv. 对立地；反面…
discover	（v. 找到；揭露；探索；发现；查明；探察
