after all	终究；毕竟
all over	到处
all the way	一路上
as long as	只要
ask for	请求；寻求
at least at most	至少/至多
at once	立刻；马上
be careful with	小心
be fond of	爱好
be keen on	喜爱
be located in or on or at	位于
a couple of	两个；几个 = several，修饰可数名词
a kind of	一种；一类
above all	首先，尤其=at first；最重要的是=in the first place
can't help doing something.	忍不住
try to do	尽力去做某事
admit doing something.	承认
consider doing something.	考虑
start to do something.	开始
need to do something.	需要
agree to do something.	同意
offer to do something.	主动
expect to do something.	期望做某事：指对未来某事的预期或期望，表示希望或预计会发生某种情况或结果。
fail to do something.	失败
advise somebody. to do	忠告
ask somebody. to do	请求
expect somebody. to do	期待
warn somebody. to do	警告
enable somebody. to do	使能够
underline	在。。。下划线；强调，使突出vt
underlined	带下划线的adj
understand	明白，懂得；理解vt（understood，understood）
understood	【过去式，过去分词】understand
united	联合的；统一的adj
until	直到prep conj == till
value	价值；价格；数值；价值观【U，C】给。。。估价；重视；珍惜【V】
traditional values	传统价值观
increase in value	升值 == rise/go up in value
decrease in value	贬值 == fall/go down in value
victory	胜利【U,C】--复数：victories
view	看法，见解；风景，景色；视野【U，C】
visitor	参观者；访问者n【C】
an exchange visit	一次交流访问
voice	嗓音【C】
volleyball	排球【C】
volunteer	志愿者【C】；自愿（做）；自愿提供【vt vi】
traffic	交通【U】
train	火车【C】；培训，训练vt
translate	翻译vt
transport	运输，运送；输送vt；【n】
transportation	运输；交通；交通工具【U】 == transport
travel	旅行【U】【vi】
trouble	问题；烦恼；麻烦；困难【U，C】；使苦恼；使麻烦【vt】
truck	卡车；货车n
try to do something	尽力做某事
turkey	火鸡【C】--复数：turkeys
turn	旋转；翻转；转弯；转变；变得【vt vi】（轮流的）顺序【C】
turn on	开，旋开（电灯，电视，收音机等）
turn down	（把音量）调低
turn up	（把音量）调高
turn out	结果是；证明是
turn over	翻（车）；翻（页）；翻身
type	类型【C】打字【Vt vi】
succeed	获得成功，达到目的vi
suddenly	突然地adv
sudden	突然的adj
suffer	受苦；遭受vi
suffer from	遭受
sugar	糖【U，C】
sun	太阳；阳光【C】
super	超级的；极好的；特级的adj == wonderful
suppose	猜想，假定，料想vi
sure	确信的，肯定的，有把握的adj（surer，surest）【近义词】certain 肯定的，确定的adj
surer	【比较级】sure
surest	【最高级】sure
survey	调查vt 【C】
survive	幸存，活下来；存活；生还vt vi
sweep	扫除，扫vt（swept，swept）
swept	【过去式，过去分词】sweep
sweet	甜的；可爱的adj；甜食；糖果【C】
symbol	符号；象征【C】
table	桌子；表格【C】
take	拿；拿走；做；吃，服用；乘坐（车、船）；花费（时间）；拍照vt（took，taken）
talent	才能；天才【U，C】
to one's great joy	使某人非常高兴的是
talk	谈话，讲话，演讲；交谈【U，C】【vi】
steak	牛排【C】
steal	偷，窃取vt（stole，stolen）
stole	【过去式】steal
stolen	【过去分词】steal
steam	蒸汽；水蒸气【U，C】
stick	木棒，枝条【C】粘住，钉住；坚持 vi（stuck，stuck）
stuck	【过去式，过去分词】stick；被卡住的，被困住的adj
stocking	长筒袜【C】 -- 复数：stockings
stop	停止；阻止vt；停；（停车）站【C】
stranger	陌生人 n
suffer from stress	承受压力
strict	严格的；严密的adj
strike	敲，打击，侵袭；（钟）鸣vt （struck，struck/stricken）
strength	精力，体力
in style	流行；时髦
reduce to	减少到
reduce by	减少了
reference	参考【U，C】
regular	规则的，经常adj
irregular	不规则的adj
relaxing	令人轻松的
release	释放，排放；发行，发表【C，u】vt
rely	依靠vi
remember doing something	记得做过的事
remember to do something	记得去做某事
remind	提醒vt == cause somebody to remember to do
repair	修理 【U，C】vt vi == fix、mend
reply	回答，答复【U，C】vt vi（replied）
reply to	答复
republic	共和国【C】
require	需求；要求vt vi == need
resource	资源【C】
response	响应；反应；作答【U，C】
restaurant	饭馆；饭店【C】
result	结果；成果【U，C】
retired	退休的adj
review	复习；评论【U,C】 vt == go over
revision	复习 n
reward	奖励，奖赏；报酬；报答，回报【C】；奖励；奖赏；给。。。以报酬vt
receive	收到，得到vt vi ==get
recognize	辨认出；认识vt vi
recorder	录音机
proverb	谚语，格言【C】 = saying
saying	谚语，格言；俗语 【C】
public	公共的，公众的adj；公众n
publish	出版vt
pull	拉；拖；拔vt
purpose	目的；用途【C】
on purpose	故意，有意地
put out	伸出；扑灭
put on a play	上演一部戏
put off the meeting	会议延期举行
put up a picture	举起/挂起图片
quality	质量【u】
quarter	四分之一；一刻钟【C】
railway	（美railroad）铁路；铁道【C】
raise a child	抚养孩子