la station de métro	地铁站
où est l'hôpital	医院在哪里？
le restaurant est ouvert	饭馆营业中
duo est vert	朵儿是绿色的
j'ai un vélo	我有一辆自行车
la pharmacie	药店
une ville française	一个法国城市
visitons	去玩；参观（第一人称复数命令式形式)意思是“让我们参观”。
voyages	“旅行”(复数形式)例如：J'aimelesvoyages.（我喜欢旅行。）
vacances	假期;度假
vont	（去）的第三人称复数形式。例如：Ilsvontàl'école.（他们去学校。）
visite	去玩；“参观；访问；（动词/名词）
pays	“国家；乡村”
voyageons	旅行、航行(第一人称复数的现在时变位形式)例如“nousvoyageons”（我们旅行）
voyagent	旅行（第三人称复数的现在时变位形式）
le mari de julia	"Julia的丈夫"
le frère de louis	"Louis的兄弟"
tu es un cheval	你是一匹马吗？
un bon café	一杯好咖啡
je suis dans le jardin	我在花园里
le chat est dans la voiture	猫在汽车里
ma famille habite dans une maison	我一家人住在一幢房子里
mon mari veut une voiture	我的丈夫想要一辆汽车
où habite ta grandmère	你祖母住在哪里？
ma maison	我的房子
les magasins sont grands	商店很大
les tables sont petites	桌子很小（复数）
la maison est grande	房子很大
les universités américaines	美国大学（复数）