Joyeux Noël	“圣诞快乐”，是在圣诞节期间人们互相祝福的常用语。;“圣诞快乐”
Tu veux du miel	你想要蜂蜜吗？
prochain	下一个，接下来的
passer	度过，参加
été	夏天，夏
faire de la plongée	去潜水
février	二月
temps	时间
Je veux faire de la plongée	我想要去潜水。
lentement	慢,慢慢地
comprenons	懂,理解,明白
sac à dos	背包
tourner	转弯(原形)
Tourne	请转弯!(命令式,如果动词是er结尾,去掉er加e)
Va tout droit	你直走(命令式)
Prends le bus	你坐公共汽车(命令式)
Va à la poste	你去邮局(命令式)
Vas-y	你去吧(命令式)(加s接元音)
Donnes-en	给我(命令式)(en代表着一些东西)(加s接元音)
Parles-en	说给我(命令式)(en代表着一些东西)(加s接元音)
Aie	请你有!(命令式,不规则)
Sois	请你是!(命令式,不规则)
Aie de la patience	请你有耐心(命令式)
Ayez du courage	请您有勇气(命令式)
Sois patient	请你是有耐心(命令式)
Soyez courageux	请您是有勇气(命令式)
immobilière	房地产的adj.
louer	租用,出租v.t.
mètre carré	平方米n.m.
placard	壁橱n.m.
le plan	平面图n.m.
le responsable	负责人,主管n.m.
les salutations	敬意n.f.pl.(信末用语)
cette année	今年(阴性名词前用cette)
cette table-là	那张桌子(阴性名词前用cette, là表示“那个”)
ces romans-ci	这些小说(复数名词前用ces, ci表示“这些”)
ces voitures-là	那些汽车(复数名词前用ces, là表示“那些”)
de...à...	从...到...
Samedi prochain, le quinze	下周六,15号
Il est huit heures du matin	现在早上八点钟
Il est minuit	现在是午夜
Il est deux heures moins le quart	现在两点差一刻钟(moins表示减去)
une heure et demie"1小时30分"
une demi-heure	半小时
la place	广场n.f.
un aller simple	单程票
un aller-retour	往返票
classe	等级,级别(n.f.)
départ	出发(n.m.)
horaire	时间表(n.m.)
pendule	挂钟,座钟;钟摆(n.f.)
À la prochaine	下次见(省略了fois)
renseignement	有关资料,情况,咨询(n.m.)
tarif	价格,定价(n.m.)
voie	道路;车道,轨道(n.f.)
rythme	节奏(n.m.)
Tu as l'heure, s'il te plaît	请问几点钟?