journaux	报纸
génial	棒,很棒的,十分好
non-fumeur	无烟的
mot de passe	密码
prendre une douche	洗淋浴
propre	干净的,净
réserver	预订
serviette	毛巾,餐巾,巾
clé	钥匙
bain	洗澡,沐浴
neige	雪,下雪
vent	风
nuage	云
dehors	外面
quart	一刻,刻
coucher	卧,上床睡觉
Le palais impérial	故宫
sévère	严格; 严厉的(形容词); 严格
croire	相信(动词); 意为“相信”。; 相信。
encore	还(副词); 副词,此处表示 “还,仍然” =英语的yet; 副词,意为 “还,仍然;再,又;更,更加”,在这里表示 “还”,用于修饰动词 “appris”,说明动作 “学习” 的状态还未完成。
oursin	海胆
tomber	陷入(某种状态)
je te crois	我相信你。
l'athlétisme	田径运动
anguille	鳗鱼
calmar	鱿鱼
Traduction	翻译
serais	动词 “être(是)” 的条件式现在时第二人称单数形式
plaisir	愉快,高兴;乐趣(名词)
faire plaisir	让...开心
Liste de vocabulaire	词汇表
cru	生的,未煮熟的”,阳性单数形式
de la sardine	沙丁鱼。
anguille	鳗鱼
crevette	虾
coquille Saint-Jacques	扇贝	shànbèi