chez toi, qui est fort en informatique	你家里谁擅长计算机?
cauchemars	“cauchemar(噩梦)” 的复数形式
cochon	名词,“猪”,阳性。
tellement	副词,意为 “如此,这样;很,非常;那么些,这么些” ,在本句中表示程度,
Dans la salle il n'y avait que des	华裔 在电影院里只有华裔。
Les immortels	不朽者。
une randonnée	徒步旅行;远足;散步” 的意思,阴性。
C'était en hiver	那是在冬天
rappelle	记得(动词“rappeler”的第1人称单数现在时变位)
ai découvert	发现了“découvert” 是动词 “découvrir” 的过去分词,“ai découvert” 构成复合过去时
caresser	摸
Pâques	复活节
des poules en chocolat	巧克力母鸡
des cloches en chocolat	巧克力钟
Des voleurs	小偷(复数)=thieves
comprend	理解,懂,知道
matière	课
dictionnaire	字典
besoin de	需要
géniaux	很棒的,棒
réunion	会议n.f.
seulement	仅仅adv.只=only
être en vacances	在度假