chez toi, qui est fort en informatique	你家里谁擅长计算机?
cauchemars	“cauchemar(噩梦)” 的复数形式
cochon	名词,“猪”,阳性。
tellement	副词,意为 “如此,这样;很,非常;那么些,这么些” ,在本句中表示程度,
Dans la salle il n'y avait que des	华裔 在电影院里只有华裔。
Les immortels	不朽者。
une randonnée	徒步旅行;远足;散步” 的意思,阴性。
oursin	海胆
tomber	陷入(某种状态)
je te crois	我相信你。
l'athlétisme	田径运动
anguille	鳗鱼
calmar	鱿鱼
Traduction	翻译
serais	动词 “être(是)” 的条件式现在时第二人称单数形式
plaisir	愉快,高兴;乐趣(名词)
faire plaisir	让...开心
Liste de vocabulaire	词汇表
cru	生的,未煮熟的”,阳性单数形式
de la sardine	沙丁鱼。
anguille	鳗鱼
crevette	虾
coquille Saint-Jacques	扇贝	shànbèi
elles sont sales	她们脏了
propres	干净的
nettoyer	清洁;打扫;擦拭
j'ai utilisé	"comme d'habitude" 我用了“像往常一样”这个表达
Ah Lisa, qu'est-ce que je vais faire de toi	啊,丽莎,我该拿你怎么办呢?
colères	形容词,“生气的,发怒的”
disait	动词 “dire(说)” 的未完成过去时第三人称单数(il、elle、on)形式
scolaire	学校的
au lieu de	代替=instead of
Tourisme–Vous visitez Montpellier en été avec vos parents	旅游 – 你夏天和父母一起参观蒙彼利埃。
organiser	组织
Votre ami français aimerait vous aider	你的法国朋友想要帮助你。
mettre d'accord	达成一致
l'organisation	组织
cette fête	这场派对
L'examinateur joue le rôle de l'ami français	考官扮演法国朋友的角色。
Vous allez au bureau de tourisme pour demander des informations sur les activités culturelles et sportives, les prix et les transports	你们去旅游局询问有关文化体育活动、价格和交通的信息。
c'est fort	这酒烈吗?
le steak tartare cru	生牛肉鞑靼
battre un record	打破纪录
1926 c'était le dernier muet 1926	年是最后一部默片。
chef d'œuvre	"作品中的佼佼者”,常翻译为 “杰作,佳作”
pâtisserie	面包店(阴性名词)
cerisier	樱花树
entendre	动词,意为 “听见,听到” 。; 听到(动词)常见的 -re 动词; 听到;听说
un dessin animé	“动画片” ,字面意思是 “活动的画” 。
suivi	参加(动词“suivre”的过去分词)、跟踪、监督
pratiques	实践的
équipe	团队
marqué	留下深刻印象(形容词,过去分词)