Et puis parce que quand on fait des études c'est mieux d'être près de l'école	“而且因为上学时,住在学校附近更好。”
grandir en ville	“在城市里长大”
un cahier de dessin	“一本绘画本”
mieux	更好(bien的比较级); “更好”=英语“better”
des jeux	“jeu” 的复数形式, “游戏;比赛;玩耍;策略”
Au lieu de dormir, il joue à des jeux vidéo	他不睡觉,而是玩电子游戏。
devrais	动词 “devoir” 的直陈式条件现在时中第二人称变位“应该;必须;得”
se fâcher	“生气;发怒”(代动词)
a souri	动词 “sourire”(微笑)的复合过去时,表明 “笑” 这个动作发生在过去。
traduire	“翻译”(动词)
traduit	动词 “traduire” 的过去分词形式,“est traduit” 构成了被动语态,表示 “被翻译”
la cinquantaine	“五十多岁”
Ils sont sages	“他们表现得好吗?”
Je regarde quels films vont être à Cannes	“我在看哪些电影将在戛纳放映。”
sera	“将会”“être(是、在)” 的简单将来时第三人称单数
depuis	介词,意为 “从......起”
leur anniversaire de mariage	“他们的结婚纪念日”
fêtent	“庆祝”,法语动词 “fêter” 的直陈式现在时第三人称复数
pratique	“方便的”=英语“convenient”
Je suis prête	“我准备好了”
même	“甚至”,在句子中起到加强语气的作用
devenir amie	“成为朋友”
devenues	动词 “devenir(成为,变得)” 的过去分词,与前面的 “êtes” 构成复合过去时。
bavarder	“聊天”
un long monologue	“一个长的独白”
Le paysage	这里的风景(阳性名词)
Nous avons admiré le paysage pendant des heures	我们欣赏了这个风景好几个小时。
montagneux	“山的;多山的”,修饰 “paysage”,说明是山区的风景。
aucun	“没有一个”,代指前面提到的 “课程(cours)” 等事物。=英语中的 “none”
actuelle	目前的,现实的,当前的adj 阴性
entraînement	训练,锻炼n.m.
éviter	避免,躲避
habituelle	习惯的,惯常的adj 阴性
libre	自由的,空闲的adj
musculation	健身,肌肉锻炼n.f.
reprendre	重新从事v.t.
reprendre le travail	重新开始工作
retourner	返回v.i.
boîte	盒子n.f.夜总会
campagne	乡村n.f.
faire de la course	奔跑
faire du jogging	慢跑
D'abord, je me lève, ensuite je me lave, après je prends le petit-déjeuner, enfin je sors de la maison	首先,我起床,然后我洗澡,之后我吃早饭,最后我出门。
Après, je me lave et je m'habille	然后我洗澡和穿衣服。
Je me lave tous les matins	我每天早上洗澡。
l'accueil	接待处
renseignez	动词 renseigner 的第二人称复数形式,意为打听、询问
Vous posez des questions sur l'accès au jardin, à la librairie boutique et sur le café restaurant du musée	“你询问如何到达花园、书店和博物馆的咖啡餐厅。”
sauf	除了
Le prix c'est 15 euros pour les adultes et 12 euros pour les moins de 18 ans	成人票价是15欧元,18岁以下的儿童是12欧元。”
sans payer	免费(payer:动词原形,意思是 “支付、付款” 。)
falloir acheter un billet	需要买票
racontes	讲述,说,瞎编(动词 raconter 的第二人称单数形式)
n'importe quoi	意为 “任何东西,乱七八糟的东西,瞎话”
te jure	发誓(动词 jurer 的第一人称单数形式)
oursin	海胆
tomber	陷入(某种状态)
je te crois	我相信你。
l'athlétisme	田径运动
anguille	鳗鱼
calmar	鱿鱼
C'était en hiver	那是在冬天
rappelle	记得(动词“rappeler”的第1人称单数现在时变位)
ai découvert	发现了“découvert” 是动词 “découvrir” 的过去分词,“ai découvert” 构成复合过去时
caresser	摸
Pâques	复活节
des poules en chocolat	巧克力母鸡
des cloches en chocolat	巧克力钟
Des voleurs	小偷(复数)=thieves